TILEMAP
36 28 							-- Size of tile map in tiles
16 32 							-- Tile size & block size
images/blocks.png 	-- Tilesheet
2 2 								-- Number of tiles in tilesheet
10 10 10 10 10 10 10 10 10 10 10 10 10 10 10 10 10 10 10 10 10 10 10 10 10 10 10 10 10 10 10 10 10 10 10 10 10 10 10 10 
10 10 10 10 10 10 10 10 10 10 10 10 10 10 10 10 10 10 10 10 10 10 10 10 10 10 10 10 10 10 10 10 10 10 10 10 10 10 10 10 
10 10 10 10 10 10 10 10 10 10 17 10 10 10 10 10 10 10 10 10 10 10 10 10 10 10 10 10 10 10 10 10 10 10 10 10 10 8 10 10 
10 11 11 3 11 11 10 10 10 10 17 10 10 10 10 10 10 10 10 10 10 10 10 10 10 10 10 10 10 10 10 10 9 10 10 10 10 16 10 10 
10 10 10 10 10 10 10 10 17 10 17 10 17 10 10 10 10 10 10 10 2 10 10 10 10 10 10 10 10 10 10 9 9 9 10 10 10 16 10 10 
10 10 10 10 10 10 10 10 17 10 17 10 17 10 10 10 10 19 10 10 5 10 10 10 10 10 10 10 10 10 10 10 10 10 15 15 10 16 10 10 
10 10 19 10 10 10 17 10 17 10 17 10 17 10 17 10 10 10 10 10 5 10 10 10 10 10 10 10 10 210 10 6 210 10 10 10 10 19 10 10 
1 1 1 1 1 1 1 1 1 1 1 1 1 1 1 1 1 1 1 1 1 1 10 10 10 10 10 10 14 14 14 14 14 14 14 14 14 14 14 14

